40
30
16 16 16 16 19 16 16 19 16 17 16 16 1 19 1 16 1 1 16 17 16 16 16 1 19 1 1 16 15 15 15 15 15 15 15 15 15 15 15 15 
1 14 1 16 16 16 16 16 16 19 16 16 16 16 16 16 14 1 16 19 16 2 16 1 16 16 16 16 15 15 15 15 15 15 15 15 15 15 15 15 
1 13 1 1 1 2 1 1 14 16 16 16 1 2 1 1 13 1 16 16 16 16 16 16 16 16 16 16 16 16 16 15 15 15 15 15 15 15 15 15 
1 12 1 1 1 1 1 1 13 1 1 16 1 1 1 1 12 7 4 4 4 4 4 4 4 4 4 4 4 4 6 15 15 15 15 15 15 15 15 15 
1 1 1 14 1 1 1 1 13 1 1 1 14 1 1 1 1 3 1 14 1 1 1 1 1 1 1 1 1 1 3 15 15 15 15 15 15 15 15 15 
1 1 1 13 1 1 1 1 13 1 1 1 13 14 1 1 1 3 1 13 1 1 1 1 1 1 1 1 1 1 3 15 10 10 10 10 10 15 15 15 
1 1 1 13 1 1 1 1 13 1 1 1 13 13 1 1 1 3 14 12 1 1 1 1 1 1 1 1 1 1 3 15 10 10 10 10 10 15 15 15 
1 1 1 13 1 2 1 1 12 1 1 1 13 13 1 1 1 3 13 1 1 1 2 1 1 1 1 1 1 1 3 15 10 10 10 10 10 15 15 15 
1 1 1 12 1 1 1 1 1 1 1 1 12 13 1 1 7 5 13 1 1 1 1 1 1 16 1 16 1 1 3 15 15 15 1 15 15 15 15 15 
4 4 4 4 4 4 4 4 4 4 4 6 1 13 1 1 3 1 13 1 2 2 1 1 1 16 16 16 1 1 3 15 15 15 1 15 15 15 15 15 
1 1 1 1 1 1 1 1 1 1 1 3 1 12 2 1 3 1 13 1 1 2 1 1 1 1 16 16 1 1 3 15 15 15 1 15 15 15 15 15 
1 1 2 1 1 14 1 1 1 14 1 3 1 1 2 1 3 1 13 1 1 1 1 1 1 1 1 1 1 1 3 15 15 15 1 15 15 15 15 15 
1 1 1 1 1 13 1 1 1 13 1 8 4 4 4 4 5 1 12 1 1 1 1 1 1 1 1 1 1 1 3 15 15 15 1 15 15 16 15 15 
1 1 1 1 1 13 1 1 1 12 1 2 1 1 1 1 1 1 1 1 1 1 1 1 1 1 1 1 1 1 3 1 1 1 1 15 15 16 16 16 
1 14 1 1 1 13 1 1 1 1 1 1 1 1 1 1 14 1 1 7 4 4 4 4 4 4 4 4 4 4 5 15 15 15 15 15 16 16 16 16 
1 13 1 1 1 13 1 1 1 1 1 1 2 1 1 1 13 1 1 3 1 1 2 16 16 16 16 16 16 16 1 1 1 1 16 16 16 16 16 16 
1 13 1 1 1 12 1 1 1 1 1 1 2 1 1 1 12 1 1 3 1 1 1 16 16 1 1 1 1 1 1 1 1 1 1 1 1 1 1 1 
1 13 1 1 1 1 1 1 14 1 1 1 14 1 1 1 1 1 1 3 1 1 1 16 16 1 16 16 1 1 1 1 1 1 1 1 1 1 1 1 
1 13 1 2 1 1 1 1 13 1 1 1 13 1 1 1 1 1 1 3 14 1 1 1 16 16 16 16 1 1 1 1 1 16 1 1 1 1 1 1 
1 13 1 1 1 1 1 1 13 1 1 1 13 1 1 1 7 4 4 5 13 1 1 1 1 16 16 16 1 1 1 1 1 16 16 16 1 1 1 1 
1 12 1 1 1 1 1 4 13 1 1 1 13 1 1 1 3 1 1 1 13 1 1 1 16 16 16 1 1 1 1 1 1 16 16 16 1 1 1 1 
1 1 1 1 1 2 1 1 13 1 1 1 12 1 1 1 3 1 1 1 13 1 1 1 1 1 1 1 1 1 16 16 1 1 1 1 1 1 1 1 
1 2 1 1 2 2 1 1 12 1 1 1 1 1 1 1 3 2 1 1 13 1 1 1 1 1 1 1 1 1 16 16 1 1 1 1 1 1 1 1 
1 1 1 1 1 1 1 1 1 1 1 1 1 1 1 2 3 2 1 1 1 1 1 1 1 1 1 1 1 1 16 16 16 1 1 1 1 1 1 1 
1 1 1 1 1 1 1 1 1 1 2 1 1 1 1 1 3 1 1 1 1 1 1 1 1 1 1 1 1 1 1 1 11 1 11 1 11 1 11 1 
1 1 1 1 1 1 1 1 1 1 2 1 1 1 1 1 3 1 1 1 1 1 1 1 1 1 1 1 1 1 1 1 1 1 1 1 1 1 1 1 
1 1 1 1 1 1 1 1 1 1 1 1 1 1 2 16 3 1 1 16 1 7 4 4 4 4 4 4 4 4 1 1 11 1 11 1 11 1 11 1 
1 16 1 16 16 16 16 16 1 1 16 16 16 16 1 16 3 16 16 16 16 3 16 16 1 1 16 1 1 1 1 1 1 1 1 1 1 1 1 1 
16 16 16 16 18 16 18 16 16 16 16 18 16 16 16 16 3 16 18 16 16 3 16 16 16 1 16 1 16 16 1 1 11 1 11 1 11 1 11 1 
16 18 16 16 17 16 17 1 16 18 16 17 16 16 18 16 3 16 17 16 16 3 16 18 16 16 16 16 16 16 16 16 1 1 1 1 1 1 1 1 
